SECTION Tiles:
W W W W W W W W W W
W F F F F F F F F W
W F F F F F F F F W
W F F F F F F F F W
W F F F F F F F F W
W F F F F F F F F W
W F F F F F F F F W
W F F F F F F F F W
W F F F F F F W W W
W W W W W W W W W W
SECTION Key:
W=wall
F=floor